╔═══╦═══╦═══╦═════════╦══════════
║   ║   ║   ║         ║         ▼
╠══ ╠═══╣ ║ ║ ╔══════ ║ ══╦═════╗
║   ║   ║ ║   ║       ║   ║     ║
╠═╦═╝ ║ ║ ╚═╗ ║ ╔═══╦═╩═╗ ╚═══╗ ║
║ ║   ║ ║   ║ ║ ║   ║   ║     ║ ║
║ ║ ══╣ ╚═╗ ╚═╣ ║ ║ ║ ║ ╠════ ║ ║
║ ║   ║   ║   ║   ║   ║ ║       ║
╠═╩═╗ ╚═╗ ╠══ ╠═══╩═╦═╝ ║ ══════╣
║   ║   ║ ║   ║     ║           ║
║ ║ ╚═╗ ║ ║ ╔═╣ ╔═══╣ ══╦═════╗ ║
║ ║   ║ ║   ║ ║ ║   ║   ║     ║ ║
║ ╠══ ║ ╚═══╣ ║ ╚══ ╠══ ║ ══╗ ║ ║
║ ║   ║     ║ ║     ║   ║   ║   ║
║ ║ ╔═╩═══╗ ║ ║ ╔═╗ ║ ╔═╩═╗ ╚═══╣
║ ║ ║     ║ ║   ║ ║ ║ ║   ║     ║
║ ║ ║ ══╗ ║ ╠═══╝ ╚═╣ ║ ║ ╚════ ║
║ ║ ║   ║   ║       ║   ║       ║
║ ║ ╚═╗ ╠═══╩═══╦══ ╠═══╣ ══════╣
║ ║   ║ ║       ║   ║   ║       ║
║ ╚═╗ ║ ║ ╔══ ══╩═══╝ ║ ║ ╔═══╗ ║
║   ║   ║ ║           ║ ║ ║   ║ ║
╠═╗ ╚═╦═╝ ║ ══╗ ╔═════╝ ║ ║ ║ ║ ║
║ ║   ║   ║   ║ ║       ║   ║ ║ ║
║ ╚═╗ ║ ╔═╩══ ║ ║ ╔═════╩═══╝ ║ ║
║   ║   ║     ║ ║ ║           ║ ║
╠═══╬═══╣ ════╝ ║ ║ ╔══ ══════╣ ║
║   ║   ║       ║   ║         ║ ║
║ ══╩══ ╠═════╦═╩═══╝ ══════╗ ║ ║
║       ║     ║             ║   ║
╠═╗ ╔═╗ ╠════ ║ ╔═════════╗ ╚═╦═╣
║ ║ ║ ║ ║       ║         ║   ║ ║
║ ║ ║ ╚═╩═╗ ║ ╔═╣ ══════╗ ╚═╗ ║ ║
║ ║       ║ ║ ║ ║       ║   ║ ║ ║
║ ║ ══╦═══╬═╩═╣ ╚═════╗ ╚═╗ ║ ╠═╣
║ ║   ║   ║   ║       ║   ║   ║ ║
╠═╣ ║ ║ ║ ║ ║ ║ ╔════ ╠══ ╠═══╣ ║
║ ║ ║ ║ ║   ║ ║ ║     ║   ║   ║ ║
║ ║ ║ ║ ╠═══╣ ║ ╚═╗ ╔═╝ ╔═╩═╗ ║ ║
║ ║ ║ ║ ║   ║ ║   ║ ║   ║   ║ ║ ║
║ ║ ║ ║ ║ ║ ║ ╠══ ║ ║ ╔═╣ ══╝ ╚═╣
║ ║ ║ ║   ║ ║ ║   ║   ║ ║       ║
╠═╝ ║ ╚═══╝ ║ ║ ╔═╩═══╣ ╠═╗   ╔═╣
║■  ║       ║   ║     ║ ║ ║   ║ ║
╚═══╩═══════╩═══╩═════╩═╩═╩═══╩═╝