╔═══╦═══╦═══╦═════════╦══════════
║   ║   ║███║█████████║█████████▼
╠══ ╠═══╣█║█║█╔══════█║█══╦═════╗
║   ║███║█║███║███████║███║     ║
╠═╦═╝█║█║█╚═╗ ║█╔═══╦═╩═╗█╚═══╗ ║
║ ║███║█║███║ ║█║███║███║█████║ ║
║ ║█══╣█╚═╗█╚═╣█║█║█║█║█╠════█║ ║
║ ║███║███║███║███║███║█║█████  ║
╠═╩═╗█╚═╗█╠══█╠═══╩═╦═╝█║█══════╣
║███║███║█║███║     ║███ ███████║
║█║█╚═╗█║█║█╔═╣ ╔═══╣█══╦═════╗█║
║█║███║█║███║ ║ ║   ║███║█████║█║
║█╠══█║█╚═══╣ ║ ╚══ ╠══█║█══╗█║█║
║█║███║█████║ ║     ║███║███║███║
║█║█╔═╩═══╗█║ ║ ╔═╗ ║█╔═╩═╗█╚═══╣
║█║█║█████║█║   ║ ║ ║█║███║█████║
║█║█║█══╗█║█╠═══╝ ╚═╣█║█║█╚════█║
║█║█║███║███║       ║███║███████║
║█║█╚═╗█╠═══╩═══╦══ ╠═══╣ ══════╣
║█║███║█║█████  ║   ║███║███████║
║█╚═╗█║█║█╔══█══╩═══╝█║█║█╔═══╗█║
║███║███║█║███ ███████║█║█║███║█║
╠═╗█╚═╦═╝█║█══╗█╔═════╝█║█║█║█║█║
║ ║███║███║███║█║███████║███║█║█║
║ ╚═╗█║█╔═╩══█║█║█╔═════╩═══╝█║█║
║   ║███║█████║█║█║███████████║█║
╠═══╬═══╣█════╝█║█║█╔══ ══════╣█║
║   ║   ║███████║███║█████████║█║
║ ══╩══ ╠═════╦═╩═══╝█══════╗█║█║
║       ║     ║      ███████║███║
╠═╗ ╔═╗ ╠════ ║ ╔═════════╗█╚═╦═╣
║ ║ ║ ║ ║       ║█████████║███║ ║
║ ║ ║ ╚═╩═╗ ║ ╔═╣█══════╗█╚═╗█║ ║
║ ║       ║ ║ ║ ║███████║███║█║ ║
║ ║ ══╦═══╬═╩═╣ ╚═════╗█╚═╗█║█╠═╣
║ ║███║███║███║███████║███║███║ ║
╠═╣█║█║█║█║█║█║█╔════█╠══█╠═══╣ ║
║ ║█║█║█║███║█║█║  ███║███║   ║ ║
║ ║█║█║█╠═══╣█║█╚═╗█╔═╝█╔═╩═╗ ║ ║
║ ║█║█║█║███║█║███║█║███║   ║ ║ ║
║ ║█║█║█║█║█║█╠══█║█║█╔═╣ ══╝ ╚═╣
║ ║█║█║███║█║█║███║███║ ║       ║
╠═╝█║█╚═══╝█║█║█╔═╩═══╣ ╠═╗   ╔═╣
║███║███████║███║     ║ ║ ║   ║ ║
╚═══╩═══════╩═══╩═════╩═╩═╩═══╩═╝